Columns: 60
Rows: 40
232323232323232323232323232323232323232323232323232323232323
454545454545454545454545454545454545454545454545454545454545
236666666000000000000000000000230000000000000000000000000023
456666666010000000001000000000450000000010666666001000000045
236666666000001000000000100000230010000000666666000000100023
450000000000000000000000000000450000000000230023000000000045
230000000000000000000000000000230000000023450045230000000023
450000000000000000000000000000450000002345000000452300000045
230001000000000100000000010000236666664566666666664566666623
450000001111110000000000000000456666662366666666662366666645
230000000111111111000000000000236666664566666666664566666623
450000000011111100000000000000450000002300000000002300000045
230000000000166666666666666666230000004523000700234500000023
450000000010066666666666666666450000000045232323451000000045
230010000000066666666666666666230010000000454545000000100023
450000000000066666666666666666450000000000000000000000000045
230000000000066666666666666666230000000006666666666660000023
450000000000066666666666666666450000000006666666666660000045
232323232323232323232323232300232323232323232300002323232323
454545454545454545454545454500454545454545454500004545454545
232323232323232323232323230000232323232323230000232323232323
454545454545454545454545450000454545454545450000454545454545
237666666666660000000000000023230000006666666666666666600023
456666666666660000001000000045450000006666666666666666600045
236666666666661000000000100023230010006666666666666666600023
456666666666660000000000000045450000006666666666666666600045
236666666666660000000023232323230000006666666666666666600023
450000000000000000000045454545450000000000000000000000000045
230001000000000100000000010023230001000000000100000000010023
450000000000000000000000000045450000000000000000000000000045
232323232323230000000000000023230000000000000000000000000023
454545454545450000000000000045450000000000000000000000000045
230000000000000000666666666623230000000000000000000000000023
450000000010000000666666666645450000000010000000001000000045
230010000000001000666666666600000010000000001000666666666623
450000000000000000666666666600000000000000000000666666666645
230000000000000000666666666623230000000000000000666666666623
450000000000000000666666666645450000000000000000666666666745
232323232323232323232323232323232323232323232323232323232323
454545454545454545454545454545454545454545454545454545454545

