Columns: 30
Rows: 20
232323232323232323232323232323
454545454545454545454545454545
230000000000000000000000000023
450000000010000000001000000045
230010000000001000000000100023
450000000000000000000000000045
230000000000000000000000000023
450000000000000000000000000045
230001000000000100000000010023
450000000000000000000000000045
230000000000000000000000000023
450000000000000000000000000045
230000000000000000000000000023
450000000010000000001000000045
230010000000001000000000100023
450000000000000000000000000045
230000000000000000000000000023
450000000000000000000000000045
232323232323232323232323232323
454545454545454545454545454545