Columns: 60
Rows: 40
232323232323232323232323232323232323232323232323232323232323
454545454545454545454545454545454545454545454545454545454545
230000000000000000000000000000230000000000000000000000000023
450000000010000000001000000000450000000010000000001000000045
230010000000001000000000100000000010000000001000000000100023
450000000000000000000000000000000000000000230023000000000045
230000000000000000000000000000230000000023450045230000000023
450000000000000000000000000000450000002345000000452300000045
230001000000000100000000010000230001004500000100004500010023
450000001111110000000000000000450000002300000000002300000045
230000000111111111000000000000230000004500000000004500000023
450000000011111100000000000000450000002300000000002300000045
230000000000111110000000000000230000004523000000234500000023
450000000010000000001000000000450000000045232323451000000045
230010000000001000000000100000230010000000454545000000100023
450000000000000000000000000000450000000000000000000000000045
230000000000000000000000000000230000000000000000000000000023
450000000000000000000000000000450000000000000000000000000045
232323232323232323232323232300232323232323232300002323232323
454545454545454545454545454500454545454545454500004545454545
232323232323232323232323230000232323232323230000232323232323
454545454545454545454545450000454545454545450000454545454545
230000000000000000000000000023230000000000000000000000000023
450000000010000000001000000045450000000010000000001000000045
230010000000001000000000100023230010000000001000000000100023
450000000000000000000000000045450000000000000000000000000045
230000000000000000000023232323230000000000000000000000000023
450000000000000000000045454545450000000000000000000000000045
230001000000000100000000010023230001000000000100000000010023
450000000000000000000000000045450000000000000000000000000045
232323232323230000000000000023230000000000000000000000000023
454545454545450000000000000045450000000000000000000000000045
230000000000000000000000000023230000000000000000000000000023
450000000010000000001000000045450000000010000000001000000045
230010000000001000000000100000000010000000001000000000100023
450000000000000000000000000000000000000000000000000000000045
230000000000000000000000000023230000000000000000000000000023
450000000000000000000000000045450000000000000000000000000045
232323232323232323232323232323232323232323232323232323232323
454545454545454545454545454545454545454545454545454545454545

